pandai berbicara	bahasa kepada manusia	SALAH
perhitungan	ketetapan Allah	SALAH
Dia ciptakan keseimbangan	menetapkan standar keadilan	BENAR
telah dibentangkan	sebagai	SALAH
mahluk-Nya	manusia	BENAR
dustakan	ingkari	BENAR
seperti	sekering	SALAH
nyala	jilatan	BENAR
barat	tempat terbenam matahari	BENAR
dilampaui oleh masing – masing	merusak air sungai	SALAH
bagaikan gunung-gunung	laksana agung	BENAR
itu akan	ini pasti	BENAR
dalam kesibukkan	membuat ketetapan	SALAH
menyelamatkan diri (darinya)	siapapun yang memberikan pertolongan	BENAR
diketahui	dikenali	BENAR
di sana dan di antara	neraka Jahanam seraya diguyur	SALAH
siapa	orang	SALAH
ada	dia mendapatkan balasan	SALAH
itu mempunyai aneka	yang memiliki	BENAR
memancar	mengalir	BENAR
terdapat	ada	BENAR
dapat	mudah	BENAR
kebaikan kecuali	atas amal shalih itu adalah pahala yang	SALAH
kelihatan	tampak sangat	BENAR
ada dua buah	terdapat	BENAR
dalam	sisi	BENAR
dan jelita	cantik cantic	BENAR
Kemuliaan	Maha Terhormat	BENAR
selalu menyesali	mencela	BENAR
demi jiwa	dengan orang	SALAH
menyusun	mengumpulkan	BENAR
maksiat terus menerus	durhaka kepada Tuhannya	BENAR
ketakutan	menghadapi maut	SALAH
dikumpulkan	disatukan sehingga tidak dapat lagi bersinar	BENAR
menjadi saksi atas	benar benar mengetahui kesalahan	BENAR
karena hendak cepat – cepat menguasainya	kepadamu	SALAH
akan	bertanggung jawab untuk	SALAH
maka	Al-Quran kepadamu barulah kamu	SALAH
akan	bertanggung-jawab untuk	SALAH
kamu	kalian	BENAR
ditimpahkan kepadanya malapetaka yang sangat dahsyat	dimasukan kedalam neraka Faqirah	BENAR
dengan	dari	BENAR
itulah waktu	dirinya akan segera	SALAH
membenarkan	mengimani	BENAR
berpaling dari kebenaran	mengingkari Allah	BENAR
Rasul	Al-Quran	SALAH
keluarganya	kelompoknya	BENAR
dia akan	bahwa dirinya	SALAH
begitu saja	hidup	SALAH
dia	manusia itu	BENAR
hanya	berasal dari	SALAH
membawa kebaikan	menyampaikan ajaran tauhid	BENAR
dijanjikan 	disampaikan para malaikat	SALAH
dihapuskan	lenyap cahayanya	BENAR
terbelah	pecah berkeping-keping	BENAR
dihancurkan menjadi debu	meletus berhamburan	BENAR
keputusan	pengadilan	BENAR
keputusan	pengadilan	BENAR
mendustakan	mengingkari adanya	BENAR
mereka	orang – orang	BENAR
yang berdosa	kafir di dunia	BENAR
kamu	kalian	BENAR
kokoh	terpelihara dengan baik	BENAR
sebaik-baiknya yang menentukan	jaga pertumbuhannya. Karena itu alangkah belas kasihanya Tuhan memelihara janin dalam Rahim itu	SALAH
berkumpul 	tinggal	BENAR
kamu mendapatkan azab	kalian ke neraka	BENAR
kamu mendapatkan naungan asap api neraka	kalian ke tempat berteduh	BENAR
pula menolak nyala	dapat menghindari diri dari jilatan	BENAR
saat mereka	manusia	BENAR
agar mereka  dimaafkan	untuk berbicara	SALAH
orang-orang yang terdahulu	nenek moyang kalian	BENAR
rasa nikmat sebagai balasan dari apa	senang hati. Inilah pahala atas amal shalih	BENAR
pasti terjadi	menimpa	BENAR
menolaknya	menolong mereka	SALAH
yang baik	tanpa mengeluh	SALAH
memandangnya dekat	menetapkan bahwa hari kiamat itu	SALAH
menjad bagaikan cairan tembaga	meleleh laksana perak yang dibakar	BENAR
yang berdosa	kafir	BENAR
sekiranya dia dapat	sekali	SALAH
seluruhnya, kemudian mengharapkan tebusan itu	sehingga ia	SALAH
yang membelakangi	kafir, kalian telah mengajak manusia meninggalkan Islam	SALAH
suka mengeluh 	rakus kepada harta lagi kikir	SALAH
kesah	berkepanjangan	SALAH
dia ditimpa kesusahan	menghadapi kesulitan	BENAR
harta dia jadi kikir	manusia enggan berbagi kepada orang lain 	BENAR
tetap setia melaksakan	selalu menegakkan	BENAR
mempercayai	mengimani	BENAR
ada seseorang yang merasa aman dari kedatanganya	dapat dihindari	BENAR
terhadap	kepada	BENAR
melampaui batas	melanggar syariat Allah	BENAR
memelihara	selalu memenuhi	BENAR
sedahsyat-dahsyatnya	diguncang dengan amat hebat	BENAR
orang-orang	golongan	BENAR
itulah	adalah	BENAR
dengan 	kepada	BENAR
terdahulu	masuk Islam lebih awal 	BENAR
kemudian	masuk Islam belakangan	BENAR
berhadap-hadapan	dipan-dipan sambil bercengkrama	SALAH
tetap muda	kekal hidupnya	BENAR
anak-anak muda	bidadari-bidadari	BENAR
inginkan	sukai	BENAR
tersimpan baik 	berjajar rapi	BENAR
tidak berduri	penuh dengan kebun-kebun	SALAH
bersusun-susun buahnya	bertandan	BENAR
terbentang luas	menyejukkan	SALAH
terlarang mengambilnya	pula sulit dipetik	BENAR
secara langsung	dewasa seketika	BENAR
jadikan mereka	ciptakan para bidadari itu semuanya	BENAR
dan	lagi	BENAR
menyenangkan	pula rasa kasih sayang	BENAR
terus menerus	senantiasa	BENAR
orang-orang terdahulu  dan yang kemudian	semua manusia, generasi pertama sampai gerenasi terakhir	BENAR
ditetapkan	dimaklumi	SALAH
mendustakan	mengingkari kebenaran adanya hari kiamat	BENAR
sangat haus	kehausan	BENAR
hidangan untuk mereka	tempat kembali orang-orang kafir	SALAH
membenarkan	mau mempercayai adanya 	BENAR
kamu	kalian. Akan tetapi	SALAH
kamu	kalian	BENAR
kamu dengan orang-orang	kalian dalam bentuk 	BENAR
kamu	telah kalian	BENAR
sampai lumat. Maka kamu akan heran tercengang	sehingga kalian tidak mendapat buahnya	SALAH
apapun	sedikitpun	BENAR
kamu	kalian	BENAR
kamu	kalian	BENAR
kamu	kalian	BENAR
kayu	menggesekan batang pohon	SALAH
menumbuhkan	menciptakannya	BENAR
menyebut nama	memuji	BENAR
dengan	demi	BENAR
beredarnya	munculnya	BENAR
sekiranya kamu mengetahui	jika kalian mau menyadari	BENAR
kamu menganggap remeh berita	kalian tetap ingkar terhadap kalam Tuhan	BENAR
mendustakanNya	berbuat kekafiran 	BENAR
telah sampai di kerongkongan nya	orang yang akan mati	BENAR
melihat	kalian menyaksikan sakaratul mautnya	BENAR
kepadanya	dengan diri kalian	SALAH
kamu	kalian	BENAR
melihat	mau menyadarinya	BENAR
kepada	dengan	BENAR
rezeki serta	ditampakkan kepadanya	SALAH
jika dia	orang yang	SALAH
mendustakan dan	kafir lagi	BENAR
disambut siraman	mendapat hidangan	BENAR
keyakinan	adalah kebenaran	BENAR
menyebut nama	memuji	BENAR
